[ ['+','+','+','+',...,'+','+','+','+','+','+','+'],
  ['+',' ',' ',' ',...,' ',' ',' ','+',' ',' ',' '],
  ['+',' ','+',' ',...,'+','+',' ','+',' ','+','+'],
  ['+',' ','+',' ',...,' ',' ',' ','+',' ','+','+'],
  ['+','+','+',' ',...,'+','+',' ','+',' ',' ','+'],
  ['+',' ',' ',' ',...,'+','+',' ',' ',' ',' ','+'],
  ['+','+','+','+',...,'+','+','+','+','+',' ','+'],
  ['+',' ',' ',' ',...,'+','+',' ',' S','+',' ','+'],
  ['+',' ','+','+',...,' ',' ','+',' ',' ',' ','+'],
  ['+',' ',' ',' ',...,' ',' ','+',' ','+','+','+'],
  ['+','+','+','+',...,'+','+','+',' ','+','+','+'] ]